0 0 0 0 0 0 0 0 0 0 0 0 0 0 0 0 0 0 0 0 0 0 0 0 0 
0 0 0 0 0 0 0 0 0 0 0 0 0 0 0 0 0 0 0 0 0 0 0 0 0 
0 0 0 0 0 0 0 0 7 7 7 0 0 0 7 7 7 0 0 0 0 0 0 0 0 
0 0 0 0 0 0 0 7 6 6 6 7 0 7 6 6 6 7 0 0 0 0 0 0 0 
0 0 0 0 0 0 7 6 0 0 0 6 7 6 0 0 0 6 7 0 0 0 0 0 0 
0 0 0 0 0 7 6 0 0 0 0 0 6 0 0 0 0 0 6 7 0 0 0 0 0 
0 0 0 0 0 7 6 0 0 0 0 0 0 0 0 0 0 0 6 7 0 0 0 0 0 
0 0 0 0 0 7 6 0 0 0 0 0 0 0 0 0 0 0 6 7 0 0 0 0 0 
0 0 0 0 0 7 6 0 0 0 0 0 0 0 0 0 0 0 6 7 0 0 0 0 0 
0 0 0 0 0 7 6 0 0 0 0 0 0 0 0 0 0 0 6 7 0 0 0 0 0 
0 0 0 0 0 0 7 6 0 0 0 0 0 0 0 0 0 6 7 0 0 0 0 0 0 
0 0 0 0 0 0 0 7 6 0 0 0 0 0 0 0 6 7 0 0 0 0 0 0 0 
0 0 0 0 0 0 0 0 7 6 0 0 0 0 0 6 7 0 0 0 0 0 0 0 0 
0 0 0 0 0 0 0 0 0 7 6 0 0 0 6 7 0 0 0 0 0 0 0 0 0 
0 0 0 0 0 0 0 0 0 0 7 6 0 6 7 0 0 0 0 0 0 0 0 0 0 
0 0 0 0 0 0 0 0 0 0 0 7 6 7 0 0 0 0 0 0 0 0 0 0 0 
0 0 0 0 0 0 0 0 0 0 0 0 7 0 0 0 0 0 0 0 0 0 0 0 0 
0 0 0 0 0 0 0 0 0 0 0 0 7 0 0 0 0 0 0 0 0 0 0 0 0 
0 0 0 0 0 0 0 0 0 0 0 0 0 0 0 0 0 0 0 0 0 0 0 0 0 
0 0 0 0 0 0 0 0 0 0 0 0 0 0 0 0 0 0 0 0 0 0 0 0 0 
0 0 0 0 0 0 0 0 0 0 0 0 0 0 0 0 0 0 0 0 0 0 0 0 0 
